{   "rows" : 16,
    "columns": 16,
    "gridSize": 82.2,
	"traversability":[
						[1,1,1,1,1,1,1,1,1,1,1,1,1,1,1,1],
						[1,0,0,0,0,0,0,0,0,0,0,0,0,0,0,1],
						[1,0,0,1,0,0,0,0,0,0,1,1,1,0,0,1],
						[1,0,1,1,1,0,0,0,0,0,0,0,0,0,0,1],
						[1,0,0,0,1,0,1,1,0,0,0,0,1,1,1,1],
						[1,0,0,0,0,0,0,0,0,0,0,0,0,0,0,1],
						[1,0,0,0,1,0,1,1,0,0,0,0,0,0,0,1],
						[1,0,0,1,0,0,0,0,0,1,1,1,0,0,0,1],
						[1,0,0,0,0,0,0,0,0,1,1,1,0,0,0,1],
						[1,0,0,0,0,0,0,0,0,0,0,0,0,0,0,1],
						[1,0,1,0,0,1,1,0,0,0,0,0,1,1,1,1],
						[1,0,0,1,1,0,0,0,1,1,0,0,1,0,0,1],
						[1,0,0,1,1,0,0,0,0,0,0,0,0,0,0,1],
						[1,0,0,1,1,0,0,0,1,1,0,0,0,0,0,1],
						[1,0,0,1,0,0,0,0,1,1,0,0,0,0,0,1],
						[1,1,1,1,1,1,1,1,1,1,1,1,1,1,1,1]
					]
}

